000000010000000
000000010000000
000000000000000
000000000000000
000000000000000
000000000001111
111111000000000
000000000000000
000000000000000
000000000000000
000000000000000
000001111110000
100000000000000
000000000000000
000000000000000
000000000000000
000000000001111
000000000000000
000000000000000
000000010000000