000001000000000
000001000000000
000001000000000
000000000000000
000000000000000
000000000000111
000000000000000
111100000000000
000000001000000
000000000100000
000000000010000
000000000000000
000000000000000
111111000000000
000000000000000
000000000000000
000000000000000
000000000100000
000000000100000
000000000100000