000000010000000
000000010000000
000000010000000
000000010000000
000000000000000
000000000000011
000000000000000
000011111100000
000011111100000
000000000000000
000000000000000
000000000000000
111000000000000
000000000000001
000000001000011
000000001000000
000000001000000
000000000000000
000000000000000
000000000000000